0000000000000000000000000000000000000000000000000000000000000000000000000000000000000000000000000000000000000000000000000000000000000000000000000000000000000000000000000000000000000000
0000000000000000000000000000000000000000000000000000000000000000000000000000000000000000000000000000000000000000000000000000000000000000000000000000000000000000000000000000000000000000
0000000000000000000000000000000000000000000000000000000000000000000000000000000000050000000000000000000000000000000000000000000000000000000000000000000000000000000000000000000000000000
0000000000000000000000000000000000000000000000000000000000000000000000000000000000000000000000000000000000000000000000000000000000000000000000000000000000000000000000000000000000000000
0000000000000000000000000000000000000000000000000000000000000000000000000000000000000000000000000000000000000000000000000000000000000000000000000000000000000000000000000000000000000000
0000000000000000000000000000000000000000000000000000000000000000000000000000000000000000000000000000000000000000000000000000000000000000000000000000000000000000000000000000000000000000
0000000000000000000000000000000000000000000000000000000000000000000000000000000000000000000000000000000000000000000000000000000000000000000000000000000000000000000000000000000000000000
0000000000000000000000000000000000000000000000000000000000000000000000000000000000000000000000000000000000000000000000000000000000000000000000000000000000000000000000000000000000000000
000080000000000000C000000000000C000000000000000000000000000000000000000000000000000000000000000000000000000000000C0000000000060C00000000000000000000000000000000000000000000000000000000
11111111100000001111100000000011110000000000C000000000C000000000C00000000000C000000700000C00000000000000000000001110000000111111111100000C0000000000000000000000000000000000000000000000
000000000000000000000000000000000000000000011100000001110000000111000000011111111111111111111000000000000C000000000000000000000000000001110000000000000000000000000000000000000000000000
000000000000000000000000000000000000000000000000000000000000000000000000000000000000000000000000000000000111000000000000000000000000000000000000C000000000000000000000000000000000000000
00000000000000000000000000000000000000000000000000000000000000000000000000000000000000000000000000C0000000000000000000000000000000000000000000011100000000000000000000000000000000000001
00000000000000000000000000000000000000000000000000000000011111111110000000000000000900000000000001110000000000000000000000000000000000000000000000000000000C0000000000000000000000000001
0000000000000000000000000000000000000000006000000000000000000000000000000000000000000000000000000000000000000000000000000000000000000000000000000000000001111100000000000000000000000001
0000000000000000000000000000000000001111111111111100000000000000000000000011111112222211111110000000000000000000000000000000000000000000000000000000000000000000000000000000000000000041
0000000000000000000001111111100000000000000000000000000000000000000000000000000012222210000000000000000000000000000000000000000000000000000000000000000000000000000000011113333111111111
0000000709000000000000000000000000000000000000000000000000000000000000000000000012222210000000000000000000000000000000000000000000000000000000000000000000000000000000000013333100000000
1111111111111111000000000000000000000000000000000000000000000000000000000000000011111110000000000000000000000000000000000000000000000000000000000000000000000000000000000011111100000000
0000000000000000000000000000000000000000000000000000000000000000000000000000000000000000000000000000000000000000000000000000000000000000000000000000000000000000000000000000000000000000